1111111111111111111111
1P00000000000000000E01
1000000000000000000001
1000000000000000000001
1000000000110000000001
100000000011000C000001
1000000000110000000001
1000000000110000000001
1000000000110000000001
1000000000000000000001
1000000000000000000001
1111111111111111111111
