111111111
111C100E1
1P0001001
111111111