111111
110E01
110001
110001
110001
110001
110001
110C01
110001
110001
110001
110001
100P01
111111