1111111111
1000000001
1P000000E1
100C000001
1111111111
