1111111111
1P001000E1
1C10001001
1111111111